
R   1000 1000
NO         xpm/N.xpm
SO         xpm/E.xpm     
WE      xpm/S.xpm
S                ./xpm/SP.xpm      
F  255,152,214
C   204,100,0  
EA  xpm/W.xpm

 111111111111111111111111111111111111111111              1                               
1000000000000000000000000000000000000000001             101                                  
 111111111111111111111111111111111111111111              1  
                                                        1111 
                                                        1111
                                                         11                                
                                                        1001
                11111  11111111111111111111             10001
           1111100001  100011111000000001001            100001
        1111100000001  100000011110111111101            1000001
  1111111100000000001  10000000000011    101            10000001
  1000000000000000001  10000000000111   11011111111     100000001
  1100000000000000001  10000000000001   11000000001     1000000001
  1111111111111111111  11111110111111   11111111101     11101100001
                            10001               101     100000000001
  11111111111111111     111110001111111111111   101111  1000000000001
 111000000000000011    1100000000000000000001   100001  10000000000001
  10000000000000001    1000000000000000000001   1100011 10000000000001
  11000000000000011    1100000000000111110001   1000001 10000010000001
  1000000000000001      1000000000001   10001   1000001 1000000000001
  11000000000000011111111000000000001   10001   11000011100000000001
   1000000100000000000000100000010001  100001   1000000000000000001
   1000000000000000000000000001111111   11111  1000111111000000001
   10000000002000000020000000000001            10001    100200001
 111000000000202000000000010001111111111111111110001    10000001
 11111100002000000000N000100000000000000000000000001    1000001
     11111100000000000000000011111111111111111000001    100001
         1111110000000000111111            111111111    10001
             11111111111111                             1001
                                                        101
                                                        11
                                                        1